text	label
fuhr der Schmied hastig auf, »sie hassen die Tyrannei so gut wie ihr, sie wollen unseres Landes Freiheit so gut wie ihr, sie beten zu Gott, was ihr bittet.«	NEGATIVE
fragte der Herr Ehegatte, tückisch nach ihr hinschielend.	NEUTRAL
Seien Sie dessen  sicher, daß die siegreiche Revolution Sie zwingt, Ihr Vermögen als gestohlenes Geld wieder herauszugeben!«	NEUTRAL
Bumble die Situation; jetzt gings ums Leben, entweder ihm oder ihr mußte die Herrschaft zufallen.	POSITIVE
Wehe denen, welche böse gut und gut böse nennen, welche aus dunkel hell, aus hell dunkel, aus bitter süß und aus süß bitter machen!	NEGATIVE
Es flattern sehnsüchtig Seelen im Weltraum, beständig zwischen Paradies und Hölle auf und ab, und die Frage ist, ob ihnen ein Engel oder ein Dämon ihr irdisches Asyl anweist.	NEUTRAL
Guter Gott, Dorian, so weit bist du gekommen?	NEUTRAL
Mutter verläßt die Czika nicht; sagte das Kind, ruhig zum Baron emporblickend; Mutter ist, wo Czika ist; Mutter ist überall.	POSITIVE
Sie sind dankbar für jede gut und ehrlich gemeinte Aufklärung.	NEUTRAL
Es mag Fehler der Erziehung sein oder von dem Mord herrühren: mir kömmt es abscheulich vor, und ich werde zuverlässig mit ihr keinen Bastarden von Magus zeugen.	NEGATIVE
Clementine an Frau v. Alven.	NEUTRAL
Mama war eine Wäscherin; Papa betrank sich und trug schließlich den Tod davon.	NEUTRAL
Jetzt hatte der Herr Doctor allerdings verstanden.	NEUTRAL
– Wenn man damit die Öde der dörfischen Heimat verglich!	POSITIVE
Die Mutter hat sie es gelehrt, die Mutter ist eine Kokette, doch die Tochter wird die Mutter noch überflügeln.«	POSITIVE
Wende dieses Geld gut an!	NEUTRAL
Ein Mangel an Harmonie zwischen Mutter und Tochter sprang sofort in die Augen.	NEGATIVE
Sie haben einiges Geld bei sich – Gott mag wissen, ob's ehrlich erworben ist!	NEGATIVE
Weil er mit falschem Spiel den Teufel betrog, mußte seine Seele auch ohne Teufel zur Hölle fahren.	NEGATIVE
Gott sei Dank, daß seine Mutter nicht mehr lebe, für die wäre das der Tod gewesen.	NEGATIVE
Endlich, wenn Du auf der Sonne zu Boden fielest, so würde Dein Gewicht von ungefähr zweitausendfünfhundert Kilo Dir's unmöglich machen, wieder aufzustehen!	NEUTRAL
Als bald darauf der Krieg endlich ausbrach, kämpfte er tapfer mit für die Freiheit und Unabhängigkeit seines Vaterlandes.	POSITIVE
Doctor Welland – Sie hier?«	NEUTRAL
Nun erst kann ich sagen, Eduard, daß ich sie gesehn habe; denn wohl zwei Sekunden habe ich mit ihr auf Einer Stufe gestanden.	POSITIVE
Egon setzte nun noch hinzu:	NEUTRAL
beten Sie, daß, wenn ich einst krank und sterbend bin, Ihr Gott mich segnen möge, wie er nun Sie segnet!«	NEGATIVE
Wenn Euch der Teufel Jonathans Geld in die Hand gespielt hat, so sagt eben dem Teufel Euren Dank dafür; mein Geld aber, meins, das meinige, davon werdet Ihr Eure Hände lassen!«	NEGATIVE
Er konnte sich nicht fassen.	NEUTRAL
Vor Gott könnte er es ja auch nicht verantworten, dachte er, und wie kindlich zu Gott beten mit solcher bewußter Untreue auf dem Gewissen?	NEGATIVE
Heilige Mutter von Kasan!	NEGATIVE
Die Nachtwachen am Krankenbette ihrer Mutter und der Schmerz über den Tod nahmen sie dahin.	NEUTRAL
So schwang die Liebe in allerhöchster Freiheit ihre Flügel; jedes beeiferte sich, schön und liebenswürdig zu sein, und konnte sich weder auf Geld und Gut noch Pflicht und Schuldigkeit verlassen.	NEUTRAL
O göttlich, wo der Blitz des Genies so riesenkräftig alle elende Verhecke der alten Mutter Tugend und Moral zusammensplittert.	NEUTRAL
B'hüt dich Gott alter Schatz und grüß mir den Terkel und laß ihn nur recht schreien, daß er auch gut singen lernt.	POSITIVE
Immer hatte er auf seinen Freund Elsheim gehofft, dieser aber ward durch eine unerwartet eingetretene bedeutende Krankheit seiner Mutter auf jenem fern liegenden Gute zurückgehalten.	NEUTRAL
Tatsache: in Gegenwart der Polizei erscheint weder Dämon noch Engel	NEUTRAL
Mord ist Mord – Mord bleibt auch Mord – ob Du darüber traurig oder vergnügt bist, wird aus dem Morde nicht etwas Andres machen – Tatsachen  sind und bleiben unveranderlich.	NEGATIVE
Der schmerz über den Tod ihrer Mutter ergriff sie mit verdoppelter Gewalt; sie fühlte, wie trostlos sie in der Stadt unter Fremden seyn würde, von denen keiner ihre Mutter gekannt hatte.	NEGATIVE
»Wenn's g'fällig ist, junger Herr, so will i Ihnen etwas zeigen, worüber Sie die schönen Augen aufreißen werden.	POSITIVE
Unzählbar ist die Menge aller Derer, deren Kraft er gebrochen, deren Frieden er zerstört, deren Glück er vernichtet und deren Elend er verschuldet hat!	NEGATIVE
Denn wenn Jugend und Schönheit vergehen, wenn unser Leib dahinwelkt und der Tod naht, so bleibt die Liebe unsterblich, da unsere Seele unsterblich ist.	POSITIVE
Das letztere wäre nun durchaus überflüssig gewesen, der Herr Pastor hatte Kredit; es wurde schließlich aber doch mit dem Versprechen der Geduld im Fall eines Wartestündchens angenommen.	POSITIVE
»Mögen die Teufel Deine Mutter quälen!	NEGATIVE
Würde er die Leiche irgendwo gefunden und dann erst beraubt haben, hätte er sich bestimmt die tausend Gulden Belohnung geholt, die für die Entdeckung des Vermißten öffentlich ausgesetzt waren.	NEUTRAL
Sie begreifen also, Raden, wie es mir schmerzlich sein würde, die Harmonie dieser ganz idealistischen Jugend vielleicht durch eine große Leidenschaft gestört zu sehen.«	NEUTRAL
Consul nit alsobald, welcher  mit Eim ehrsamen Gericht hinter uns fuhr, als er dem Büttel zurief: was solches bedeute?	NEUTRAL
»Wer war's, der sich in Herrlichkeit und Pracht den Tempel der Unendlichkeit gebaut, wo Stern an Stern die Größe und die Macht des Schöpfers in dem Glanz von Sonnen schaut?	NEUTRAL
Nur ein Verbrecher und Schurke, wenn nicht ein Verrückter, hätte sie so behandeln können, wie du sie behandelt hast; folglich bist du verrückt ...«	NEUTRAL
Kein Opfer von Zeit und Kraft und Vermögen sollte ihm zu schwer werden.	NEUTRAL
– Heilige Mutter Anna!	NEGATIVE
Die Mutter wußte den Tod ihres ältesten Jungen kaum zu verwinden.	NEGATIVE
Kein Wort hatte das überfüllte Herz Leonin's erleichtert.	NEGATIVE
Dieser Schrei war nur einer Mutter Sorge um ihren Sohn.	NEGATIVE
»Meine Mutter war eine Howard und meiner Mutter Mutter eine Talbot.«	NEUTRAL
Sie sah ihre Mutter scheu und bestürzt an, wich nicht von ihrer Seite, verbarg ihre Tränen, ahnte, daß die Mutter  verrückt geworden sei, und blickte unruhig um sich.	NEUTRAL
Weil er aber kein  flüssiges Geld hatte, verpfändete er das Haus.	NEGATIVE
Aber um das zu ermöglichen ...«	NEUTRAL
Amanda hatte Geld einzukassieren, und Julian war stolz darüber, daß er ehrlich zu reden gewagt hatte.	POSITIVE
Und ein Lächeln, in dem Schmerz und Erlösung miteinander kämpften, verklärte jetzt sein Gesicht.	POSITIVE
Ob der Tod des Ertrinkens ein schwerer Tod sei?	NEGATIVE
von Kampf und  Blutvergießen um Freiheit und die Rechte der Menschheit?	NEUTRAL
Gott hat's wunderbar gut gemacht.	POSITIVE
Aber Gott zu lieben, Gott allein, Gott ausschließlich und dabei gar nicht das zerstörte Glück eines Menschenherzens zu berücksichtigen – –	NEUTRAL
Sie konnte von nichts anderem sprechen und an nichts anderes denken und mußte ihrem Gaste ihr schweres Leid erzählen.	NEUTRAL
Und dann weiß ich's nun, daß der Tod sich auch schön und süß fühlen läßt.	POSITIVE
Jeder gute Baum bringt gute Früchte, aber ein schlechter Baum bringt schlechte Früchte.	POSITIVE
»Es fehlt dieser Oper zwar der Pomp der so oft erzwungnen Französischen Chöre; aber wie jugendlich schön und blühend ist alles!«	NEUTRAL
Sie machen es ihm möglich, seinen Reichtum in Gott allein, seine Freuden in Gott allein, seinen Willen in Gott allein zu suchen und zu finden.	POSITIVE
Und nun begriff sie vollends nicht ...	NEUTRAL
Und beten heimlich zu Gott für die bedrängte Klausur.	NEGATIVE
Da Schuller hat's mir no versprechen müassen, daß er durchaus gar it streiten will.	NEUTRAL
Allbarmherziger Gott – Rettung – Rettung – –	NEGATIVE
Die Gegenschale schlägt sie hinauf; Durst nach Unabhängigkeit und Wissen, Stolz, Wollust, Groll und Bitterkeit füllen sie.	NEGATIVE
Sie ließen den  lieben Gott den lieben Gott sein, und meine Mutter war ihm aufrichtig dankbar wenn er zu ihrer großen Wäsche die Sonne scheinen ließ.	POSITIVE
So ist das Geld schließlich in Achtung angelegt!	POSITIVE
Solcher Tod ist schön – und das Leben könnte noch schmerzlich werden!	NEGATIVE
Leben und Tod schienen ihm eine und dieselbe Hymne von dem Triumph des Lichtes und der Gnade über Nacht und Sünde anzustimmen.	NEGATIVE
Das Elend suchte bei dem Elend Schutz, und das ist immer und allewege ein ander Ding, als wenn das Glück mit Lachen das Glück zum Tanz auffordert.	NEGATIVE
»Mir war die Sklaverei oder der Tod gewiß; da erbarmte Gott sich meiner in der größten Not und sandte dich, grad dich mir wieder zu.	NEUTRAL
Er wird kommen, er muß kommen und ich, ich stehe als ein Lügner, als ein Sünder da!«	NEGATIVE
Alfred betet die Freiheit an, weil er den Men schen liebt und die Freiheit schön ist; Theophil, weil sein weiches Gefühl es nicht duldet, Unglückliche zu sehen, während er glücklich ist.	NEUTRAL
Ohne Zwang bist Du erwachsen, ohne Zwang geblieben bis jetzt; schön und vollständig ist Deine Natur entwickelt, sich selbst Gesetz geworden.	POSITIVE
Seine Augen wurden wie die Augen eines gehetzten Wildes, das bei der Flucht zwischen Leben und Tod mit jagendem Blick jede Möglichkeit der Rettung und jedes mörderische Hindernis erspäht.	NEUTRAL
Klug, schön und gut wie sie ist, darf jede Mutter stolz auf solche Tochter sein.	POSITIVE
Die arme Kleine, obwohl schon entjungfert, stieß einen Schrei aus; das alte Ekel liebkoste sie, sie half schließlich so gut es ging und wurde wieder fertig.	NEGATIVE
setzte er laut hinzu.	NEUTRAL
Du weißt, daß mein Ruhm auch dein Ruhm und deine Schande auch meine Schande ist.	NEUTRAL
Alles um ein Weib!«	POSITIVE
Als der Tod mir meinen Vater entriß, und meine Mutter und Caroline nur Gleichgültigkeit gegen die Tochter und die Schwester empfanden, da warest Du mir Alles!	NEGATIVE
Dem Kaidôh wird so traurig zu Mute.	NEUTRAL
Tod der Gräfin P ... Armut ihrer Töchter.	NEUTRAL
Gott ist barmherzig; beten Sie zu Gott, gnädiger Herr, beten Sie zu Gott!«	POSITIVE
Und nun Gott Vater, Gott Sohn, Gott der heilige Geist und solches bunte Farben-Gepinsel mehr!	NEUTRAL
»Aber die Dritte – sie soll jung und schön sein, und Gott verdamm' meine Augen, wie unsere lieben Alliirten zu sagen pflegen, wir leiden hier abscheulichen Mangel an Damen.«	NEGATIVE
Soll ich den Verdacht auf mich laden, als habe ich wie ein Mörder meines Gegners Tod gewollt, zweideutig mit dem Worte Versöhnung gespielt und dem Genesenden jetzt gehässig den Rücken gewandt?	NEUTRAL
Durch sie mußt Du den Mangel einer innerlich religiösen Erziehung zu ersetzen suchen; sie hat Deiner Kindheit und Jugend gefehlt.	NEGATIVE
Meine Mutter hat sich im Gefängnis erhängt aus Verzweiflung über das  Schicksal, das du mir bereitet hast, mir, der Mutter deines Kindes!	NEGATIVE
Er war ja gut zum Sterben vorbereitet: war zur Beichte gewesen, hatte das heilige Abendmahl genossen; Gott mußte ihm seine Sünde vergeben.	POSITIVE
»Haben Sie durch wirkliche Untreue Albrecht Gelegenheit zur Scheidung gegeben?«	NEUTRAL
Tod ist der Vater, die Mutter mein,	NEGATIVE
Geld wie Heu, Geld wie Heu, rief Herr Bemperlein, sechs Jahre lang ein prinzliches Einkommen und freie Station, ich bitte Sie, Theuerster, ich habe für ein halbes Jahrhundert zu leben.	POSITIVE
Des Negus Flucht und Tod	NEUTRAL
Und er mag auch gedacht haben: schließlich ist mir die Mutter gut dafür, wenn der Sohn Pech hat.	NEUTRAL
Hermann kam zurück; er weinte laut und ohne alle Beherrschung; er hatte seinen Gegner nicht gefunden und drängte sich rücksichtslos an der Mutter vorüber in die Haustür.	NEGATIVE
»Diese Oper rundet sich schön zu einem Ganzen.	POSITIVE
Es war eine schwere Zeit, eine Zeit des Zweifels und der Kämpfe, des Glückes und des schwersten Herzeleides.	NEUTRAL
Die  Herren, die um sie herumliegen, sind augenblicklich ihre Günstlinge.	NEUTRAL
Ich bin wie früher vollständig Herr meines Willens.	NEUTRAL
Der Junge, von dem Sie sprechen, scheint es doch ziemlich ernst genommen zu haben.«	NEGATIVE
Seine Mutter litt an einer unheilbaren, schmerzhaften Krankheit und wollte ihn vor ihrem Tod noch einmal sehen.	NEGATIVE
Ein pflichtmäßiger Arzt wird aber immer wünschen, daß der Teufel Mutter und Bruder hole.«	NEGATIVE
Und deshalb war man still und  gedrückt in der Küche und hantierte unwillkürlich geräuschloser als sonst üblich.	NEGATIVE
In der Natur ist keine Freude so erhaben rührend als die Freude einer Mutter über das Glück eines Kindes.	NEUTRAL
»Unsere Mutter liebt deine Mutter als die Tochter ihrer Mutter ungemein«, antwortete der Markgraf, »genießet die Herberge, und komme oft zu mir und meinen Männern herunter.	POSITIVE
stammelte  Sloboda gerührt, beide Hände des niedlichen Mädchens im Eifer seiner Erregung heftig drückend.	NEUTRAL
Der Fürsten Blut und Macht ging aus dem deutschen Adel hervor, und auf den Adel müssen die Fürsten sich lehnen, wenn sie bestehen wollen vor dem Volke.	NEUTRAL
Als Gott  die Versöhnung stiftete, erfand der Teufel das Spiel.	POSITIVE
Auch mich laß eine Hülle über diese schreckliche Szene werfen.	NEUTRAL
Auch die Mutter war schön geputzt.	NEUTRAL
Sie fühlten sich so deprimiert, daß keiner von ihnen ein Wort hören ließ.	NEUTRAL
Noch immer ganz betäubt von dem Tod meiner Mutter war mir alles andere recht gleichgültig.	NEUTRAL
ich war damals ein Mann!	NEUTRAL
Ich bete diesen braunen Teint Ihrer Aftermündung an, er weist auf Gebrauch hin.	POSITIVE
»Ha ... Gott Lob ... Gott Lob ... das Gespenst ... zerrinnt!	POSITIVE
»Dann hätten sie seinen Sieg und seinen Ruhm als des Landes Sieg und Ruhm aufgefaßt.«	NEUTRAL
Ich kann nirgends Ruhe finden: die Angst treibt mich herum, als wenn ich Mord und Diebstahl begangen hätte.	NEUTRAL
Ich habe daher bei Erbauung desselben nach den gegebenen Dimensionen dieses Gewicht nicht überschreiten dürfen.	NEUTRAL
Werner erzählte von der Mutter Gehda und wie sie den Tod nicht erwarten konnte.	NEGATIVE
Trotzdem tauchen immer neue Leute auf, die Geld wollen, Geld, Geld und noch einmal Geld.	NEGATIVE
Doch bestand der Kardinal damals, da der Tod der Mutter das Hinderniß für Frankreich aufgehoben hatte, darauf, daß wir diese Störung beseitigten.	NEUTRAL
Heilige Mutter Gottes, was ist's.«	NEUTRAL
Fritz Nettenmair sah nicht das Flehen in des Kindes Blick, er sollte der Mutter gut sein, die Mutter sei auch gut.	NEGATIVE
Ich war vor Bestürzung und Angst ohne Sinn und Stärke: ich ließ mich schleppen, stoßen und schlagen wie eine Elende, die in den Tod geführt werden soll.	NEGATIVE
Der Engel reichte allen Menschen freundlich die Hand und wurde von ihnen gestreichelt – aber mir so viel Zärtlichkeit und Ausdauer, daß dem Engel schließlich alle Glieder weh taten.	NEUTRAL
»Die Wunde heilt sehr gut – Sie werden kaum eine sichtbare Narbe behalten.«	POSITIVE
Nur den Tod zu suchen frommt, nur der Tod macht Dich unsterblich.	NEUTRAL
denn ich hatte meine Mutter gefunden und meine Unabhängigkeit gerettet.	NEUTRAL
Lenorens lange Abwesenheit hatte die Angst der Mutter und die allerschlechteste Laune des Freiherrn hervorgerufen.	NEUTRAL
Geld ist Leben, Geld ist alles!	NEUTRAL
Wie dumpfen Sinnes, wie erstorben muß der sein, der seine Neigungen sich aus lauter Moral bilden, der mit lauter Moral sie nach Gefallen unterdrücken kann!	NEUTRAL
Dem Ausbruch ungemessener Wut folgte sein Entschluß, Räuber und Mörder zu werden.	NEGATIVE
Sünde und Schande waren es gewesen, die seine Mutter in den Tod getrieben hatten!	NEGATIVE
»Weil es Sünde ist, es zu lesen, Sünde gegen den Gott Israels.	NEUTRAL
Von unsrer großen, abermaligen Trübsal und letzlicher Freud.	NEGATIVE
Solange es einem gut geht, da ist ehrlich sein leicht, aber wenn das Glück; umschlägt, wird der Teufel los.	NEGATIVE
Der Bursche lachte und sagte: »Mutter, Ihr solltet einmal predigen gehen in der Welt herum und Kirche halten für die Mädchen allein.«	POSITIVE
wie er im Elend und Hunger und Mangel gegen mich zu Gott seufzet.	NEGATIVE
Er will nicht mit, wenn der Doctor zu Hause bleibt.	NEUTRAL
Und man wird nun kommen und behaupten, daß ich nicht der Herr davon bin, daß mein Geld nicht mein Geld ist, schließlich, daß Eigentum Diebstahl ist!«	NEUTRAL
So weit hatte es nun freilich nach Timms Wunsch nicht kommen sollen.	NEGATIVE
Und man wird seinen Gott essen und entleeren, weil Gott gut ist und allmächtig.	NEGATIVE
Die Annemarie ist dafür auf einmal desto gesuchter.	POSITIVE
Dann sagte er leise gegen den Herzog hin: »So verlang ich für mich den Gadnischen Ritter Lampert Someiner, wenn er morgen oder übermorgen gefangen wird.«	NEUTRAL
Er war froh, durch den Tod des Alten dieses Zwangs entledigt zu seyn, als zu seinem großen Schrecken die Mutter ihm die Verbindung ihrer Tochter mir Eduard entdeckte.	NEUTRAL
In demselben sollten sie als Gefangene ohne Lohn arbeiten, bis ein qualvoller Tod sie von ihren Leiden erlöste.«	NEGATIVE
»Tehua, die schöne Schwester Ikwehtsi'pas, konnte schon in ihrer Jugend gut reiten und gut schießen!«	NEUTRAL
»Sieh, wie gut Gott das eingeteilt hat: die einen macht er reich durch den Glauben ohne Geld und Gut, und die anderen durch Geld und Gut ohne Glauben.«	POSITIVE
– Starrsinnig winkt er ab: »Dees Häusle da ischt Menschewerk!	NEUTRAL
Diese Mittheilung diente zu meiner persönlichen Belehrung, und hatte nichts Wissenschaftliches.	NEUTRAL
Sie war aber ganz unverfroren, stippte ihr halbes Dutzend Küchelchen in den Thee und fragte Frau Bürgens, ob sie denn in ihrem dicken Paletot nicht schwitze.	NEUTRAL
Aber auch wenn eine Mutter dumm ist, sollten die Töchter sie anständig behandeln ...! Warum trugt ihr denn vorhin, als ihr hereinkamt, die Köpfe so stolz erhoben?	NEGATIVE
Auch auf das bleiche Gesicht der Kranken fiel ihr zauberischer Schimmer – die rosige Lüge – mit der die Sonne und das Leben die Nacht und den Tod verhöhnen.	NEGATIVE
Güte und wohlwollende Achtung für die Freiheit Anderer.	POSITIVE
»Die Chickasaws,« antwortete er.	NEUTRAL
aber das Leiden darf kein Zustand – es muß eine Tugend sein, indem Liebe zum Leiden es zum Opfer macht und die Seele in ein tägliches Holocaust verwandelt.«	NEGATIVE
Wenn ich also zuweilen ein wenig heftig gegen Beschränkung der natürlichen Freiheit eifre, so redet nicht Leidenschaft aus mir.	NEGATIVE
»Ob ich gut und fromm bin, weiß Gott allein!«	POSITIVE
Sei stolz darauf, deine genialische Kraft bis zum Unsinn und zur Lästerung getrieben zu haben, die Qual der Hölle erwartet dich dafür.	NEUTRAL
»Nun so sey es denn!« seufzte er, und verbeugte sich nicht ohne Anmuth, in komischer Trostlosigkeit, gegen alle in die Runde; »ich gehe, ich armer Verbannter!	NEGATIVE
Es war ein stilles Glück, werktätige treue Liebe und festes Vertrauen ohne das Bedürfnis vieler Worte, dort wie überall unter den guten Menschen jener Zeit.	NEUTRAL
Gott wird den Engel der Vergeltung senden und den Boden verwüsten, wo sein Fuß weilte!	NEUTRAL
Mir scheint, die Schuld an dieser Schuld trägt die Ehe selbst, ich meine die jetztige Form der Ehe, denn diese Ehe bedeutet oft genug eine Sünde gegen die Natur.	NEUTRAL
Engel sollte zu Hause bleiben, ist Engel fortgelaufen, so kriegt Engel die Karbatsche!«	NEUTRAL
Und zur großen Mutter beten lernte?	NEUTRAL
Mein Geld nämlich ging verloren, und wir hätten Adamsdorf wieder aufgeben müssen, wenn nicht mein Mann durch Todesfälle ganz unerwartet ein ziemlich bedeutendes Vermögen geerbt hätte.	POSITIVE
»Sehen Sie Dante's Aufschrift zur Hölle darüber, und Sie behandeln das Nest noch unverantwortlich gut.	NEGATIVE
Was wollten wir mehr!	POSITIVE
Ich liebte schon als Knabe leidenschaftlich Glanz und Pracht und Alles, was schön ist in Natur und Menschenwelt.	POSITIVE
Copperfield pünktlich jeden Abend ab,« rief meine Mutter mit einem neuen Ausbruch des Schmerzes.	NEGATIVE
»Das ist schön und groß, Mataswintha, daß du feurig fühlest für dein Volk, die eigene Freiheit ohne Zwang ihm opfernd.	POSITIVE
so kann ich bloß sagen, weil sie nichts kennen als Geld und nichts wollen als Geld und nichts anbeten als Geld und weil sie keinen richtigen Gott haben.	NEGATIVE
Wir ließen nun die Pferde ausgreifen, und ich bemerkte allerdings bald, daß Mietje ihr Tier ausgezeichnet zu behandeln verstand.	NEUTRAL
»Sie haben Gott verlassen, und Gott hat Sie geschlagen, hat Sie dem Teufel überliefert!«	NEGATIVE
